111111111
100000E01
100100CP1
111111111
