1111111111111
1100C000000C1
1P00001111111
100011E000001
1111111111111
