1111111111111
1100C000000C1
1000000111001
10P011E000001
1111111111111
