11111111111
11C100C1001
11000000E01
11000001001
1C0P0100101
11111111111
