111111111
1P11010C1
1CE000111
111111111
